* ausreißerkind	\R3^7K*D	1SR3^ERKIND
* ausreisserkind	\R3^7K*D	1SR3SSERKIND
* breitestraße	BR3(]RA^E	BR3TE]RA^E
* breitestrasse	BR3(]RA^E	BR3TE]RASSE
n dinehart	D*EH)T	DINEHART
* doktorhaus	DOKT?H1S	DOKTORH1S
n epagnier	EPAGNI7	EPAGNIER
* escalier	%'C:I7	ESCALIER
n estancia	E]+'CIA	E]ANCIA
* gequirlte	&'QUIRL(	GEQUIRLTE
* goldrange	GOLDR+&	GOLDRANGE
* grigio	GR>IO	GRIGIO
n gutierre	GUTI7RE	GUTIERRE
* labortechnik	LAB?TK	LABORTE4NIK
* megalith	MEG:ITH	MEGALITH
* megaliths	MEG:ITHS	MEGALITHS
* megaloman	MEG:OMAN	MEGALOMAN
n meinier	M6I7	M3NIER
* montmartrehäuser	MONTM)TREH\S7	MONTMARTREH\SER
n nathanael	NATH+AY	NATHANAEL
d niemer	NI[7	NIEMER
n pâquier	Pâ'QUI7	PâQUIER
* pardonner	P)DONN7	PARDONNER
* parlierten	P)L0RTC	PARL0RTEN
n salvatierras	S:VATI7RAS	SALVATIERRAS
n salvatierra	S:VATI7RA	SALVATIERRA
* spezialschiffe	SPEZI:5IFFE	SPEZIAL5IFFE
* spezialthema	SPEZI:TH[A	SPEZIALTHEMA
* titanfarbenen	TIT+F)BCC	TITANFARBENEN
n veyrier	VE'YRI7	VEYRIER
* vignetten	V>NETTC	VIGNETTEN
* vignette	V>NET(	VIGNETTE
n vignogn	V>NOGN	VIGNOGN
* wacherhalten	W<7H:TC	WA4ERHALTEN
* weicheier	W3437	W343ER
